5 5
1 1
3 2 2 2 4
5 0 0 0 5
5 1 0 0 5
5 1 0 1 5
3 2 2 2 4