20 20
200 100
3 2 2 2 2 2 2 2 2 2 2 2 2 2 2 2 2 2 2 4
5 1 1 1 1 1 1 1 1 5 1 1 1 1 1 1 1 1 1 5
5 0 5 0 0 0 0 0 0 5 0 0 0 0 0 0 0 0 0 5
5 1 1 1 1 1 1 1 1 5 0 0 0 0 0 0 0 1 0 5
5 0 0 0 0 3 2 2 2 4 0 0 0 0 0 0 0 0 0 5
5 1 1 1 0 0 5 0 0 0 0 1 1 0 1 1 1 1 1 5
5 0 0 0 0 0 0 0 0 0 0 0 0 0 0 0 0 0 0 5
5 1 1 1 1 1 0 1 1 1 1 1 1 0 1 1 1 1 1 5
5 0 0 0 0 0 0 0 0 0 0 0 0 0 0 0 0 0 0 5
5 1 1 1 1 0 1 1 1 1 1 0 0 3 2 4 0 0 1 5
5 0 1 0 0 0 0 0 0 0 0 3 2 2 4 0 0 0 0 5
5 1 1 1 1 1 5 1 1 1 1 1 5 1 1 1 1 1 1 5
5 0 0 0 0 1 1 1 1 1 1 1 0 0 0 0 0 0 0 5
5 1 1 1 1 1 1 1 1 1 1 1 1 1 1 1 1 1 1 5
5 0 0 0 1 0 0 0 0 0 1 0 0 0 0 0 0 0 0 5
5 1 1 1 1 1 1 1 1 1 1 1 0 0 0 0 1 1 1 5
5 0 0 0 0 0 0 0 0 0 0 0 0 0 0 0 0 0 0 5
5 1 1 1 0 1 1 1 1 1 1 0 1 1 1 1 1 1 1 5
5 0 0 1 1 1 0 1 0 0 0 0 0 1 0 0 0 0 0 5
3 2 2 2 2 2 2 2 2 2 2 2 2 2 2 2 2 2 2 4